 __________ 
S  |       |
|  |  | |  |
|     | |  |
|_____|_|  |
|          |
|---  -----|
|     |     
| ----     |
|          |        
|__________|
            